#,#,#,#,#,#,#,#,#,#,#
#,.,.,.,.,.,.,.,.,.,#
#,.,.,#,.,#,.,.,.,.,#
#,.,.,#,.,#,.,.,.,.,#
#,.,.,#,.,#,.,.,.,.,#
#,.,.,#,.,#,.,.,.,.,#
#,.,.,#,.,#,.,.,.,.,#
#,.,.,#,.,#,.,.,.,.,#
#,.,.,#,.,#,#,#,#,.,#
#,.,.,#,.,.,.,.,#,.,#
#,.,.,#,#,#,#,.,#,.,#
#,.,.,#,.,.,.,.,#,.,#
#,.,.,#,.,#,#,#,#,.,#
#,.,.,#,.,#,.,.,.,.,#
#,.,.,#,.,#,#,#,#,.,#
#,.,.,#,.,.,.,.,#,.,#
#,.,.,#,#,#,#,#,#,.,#
#,.,.,.,.,.,.,.,.,.,#
#,.,.,.,.,.,.,.,.,.,#
#,.,.,.,.,.,.,.,.,.,#
#,#,#,#,#,#,#,#,#,#,#
